dk	あ
kd	あ
dj	い
jd	い
dh	う
hd	う
d;	え
;d	え
dl	お
ld	お
fk	か
kf	か
fj	き
jf	き
fh	く
hf	く
f;	け
;f	け
fl	こ
lf	こ
ak	さ
ka	さ
aj	し
ja	し
ah	す
ha	す
a;	せ
;a	せ
al	そ
la	そ
gk	た
kg	た
gj	ち
jg	ち
gh	つ
hg	つ
g;	て
;g	て
gl	と
lg	と
sk	な
ks	な
sj	に
js	に
sh	ぬ
hs	ぬ
s;	ね
;s	ね
sl	の
ls	の
rk	は
kr	は
rj	ひ
jr	ひ
rh	ふ
hr	ふ
r;	へ
;r	へ
rl	ほ
lr	ほ
tk	ま
kt	ま
tj	み
jt	み
th	む
ht	む
t;	め
;t	め
tl	も
lt	も
wk	や
kw	や
wh	ゆ
hw	ゆ
wl	よ
lw	よ
wj	、
jw	、
w;	。
;w	。
ek	ら
ke	ら
ej	り
je	り
eh	る
he	る
e;	れ
;e	れ
el	ろ
le	ろ
ei	っ
ie	っ
qk	わ
kq	わ
qj	ゐ
jq	ゐ
qh	ヴ
hq	ヴ
q;	ゑ
;q	ゑ
ql	を
lq	を
di	ぁ
id	ぁ
du	ぃ
ud	ぃ
dy	ぅ
yd	ぅ
dp	ぇ
pd	ぇ
do	ぉ
od	ぉ
fi	が
if	が
fu	ぎ
uf	ぎ
fy	ぐ
yf	ぐ
fp	げ
pf	げ
fo	ご
of	ご
ai	ざ
ia	ざ
au	じ
ua	じ
ay	ず
ya	ず
ap	ぜ
pa	ぜ
ao	ぞ
oa	ぞ
gi	だ
ig	だ
gu	ぢ
ug	ぢ
gy	づ
yg	づ
gp	で
pg	で
go	ど
og	ど
si	ん
is	ん
su	ー
us	ー
sy	ヵ
ys	ヵ
sp	ヶ
ps	ヶ
so	・
os	・
ri	ば
ir	ば
ru	び
ur	び
ry	ぶ
yr	ぶ
rp	べ
pr	べ
ro	ぼ
or	ぼ
ti	ぱ
it	ぱ
tu	ぴ
ut	ぴ
ty	ぷ
yt	ぷ
tp	ぺ
pt	ぺ
to	ぽ
ot	ぽ
wi	ゃ
iw	ゃ
wy	ゅ
yw	ゅ
wo	ょ
ow	ょ
qi	ゎ
iq	ゎ
d,	人
dm	一
d.	日
dn	大
d/	年
f,	出
fm	本
f.	中
fn	子
f/	見
s,	国
sm	言
s.	上
sn	分
s/	生
g,	手
gm	自
g.	行
gn	者
g/	二
a,	間
am	事
a.	思
an	時
a/	気
e,	会
em	十
e.	家
en	女
e/	三
r,	前
rm	的
r.	方
rn	入
r/	小
w,	地
wm	合
w.	後
wn	目
w/	長
t,	場
tm	代
t.	私
tn	下
t/	立
q,	部
qm	学
q.	物
qn	月
q/	田
ck	何
cj	来
cl	彼
ch	話
c;	体
vk	動
vj	社
vl	知
vh	理
v;	山
xk	内
xj	同
xl	心
xh	発
x;	高
bk	実
bj	作
bl	当
bh	新
b;	世
zk	今
zj	書
zl	度
zh	明
z;	五
ci	戦
cu	力
co	名
cy	金
cp	性
vi	対
vu	意
vo	用
vy	男
vp	主
xi	通
xu	関
xo	文
xy	屋
xp	感
bi	郎
bu	業
bo	定
by	政
bp	持
zi	道
zu	外
zo	取
zy	所
zp	現
c,	最
cm	化
c.	四
cn	先
c/	民
v,	身
vm	不
v.	口
vn	川
v/	東
x,	相
xm	多
x.	法
xn	全
x/	聞
b,	情
bm	野
b.	考
bn	向
b/	平
z,	成
zm	軍
z.	開
zn	教
z/	経
ask	信
asj	近
asl	以
ash	語
as;	面
asi	連
asu	問
aso	原
asy	顔
asp	正
as,	機
asm	九
as.	次
asn	数
as/	美
adk	回
adj	食
adl	表
adh	八
ad;	声
adi	水
adu	報
ado	真
ady	味
adp	界
ad,	無
adm	少
ad.	要
adn	海
ad/	変
afk	結
afj	切
afl	重
afh	天
af;	神
afi	記
afu	木
afo	集
afy	和
afp	員
af,	引
afm	公
af.	画
afn	死
af/	安
agk	兵
agj	親
agl	六
agh	治
ag;	決
agi	太
agu	氏
ago	衛
agy	強
agp	使
ag,	込
agm	朝
ag.	受
agn	島
ag/	解
sdk	市
sdj	期
sdl	様
sdh	村
sd;	活
sdi	頭
sdu	題
sdo	万
sdy	組
sdp	仕
sd,	白
sdm	指
sd.	説
sdn	七
sd/	能
sfk	京
sfj	葉
sfl	第
sfh	流
sf;	然
sfi	初
sfu	足
sfo	円
sfy	在
sfp	門
sf,	調
sfm	笑
sf.	品
sfn	電
sf/	議
sgk	直
sgj	着
sgl	保
sgh	別
sg;	夫
sgi	音
sgu	選
sgo	元
sgy	権
sgp	特
sg,	義
sgm	父
sg.	利
sgn	制
sg/	続
dfk	風
dfj	北
dfl	石
dfh	車
df;	進
dfi	夜
dfu	伝
dfo	母
dfy	加
dfp	助
df,	点
dfm	産
df.	務
dfn	件
df/	命
dgk	番
dgj	落
dgl	付
dgh	得
dg;	半
dgi	戸
dgu	好
dgo	空
dgy	有
dgp	違
dg,	吉
dgm	殺
dg.	起
dgn	運
dg/	置
fgk	料
fgj	士
fgl	返
fgh	藤
fg;	論
fgi	楽
fgu	際
fgo	歳
fgy	色
fgp	帰
fg,	歩
fgm	井
fg.	悪
fgn	広
fg/	店
gfk	反
gfj	町
gfl	形
gfh	百
gf;	光
gfi	首
gfu	勝
gfo	必
gfy	土
gfp	係
gf,	由
gfm	愛
gf.	都
gfn	住
gf/	江
gdk	西
gdj	売
gdl	放
gdh	確
gd;	過
gdi	張
gdu	約
gdo	馬
gdy	状
gdp	待
gd,	古
gdm	想
gd.	始
gdn	官
gd/	交
gsk	読
gsj	千
gsl	米
gsh	配
gs;	若
gsi	終
gsu	資
gso	常
gsy	果
gsp	呼
gs,	校
gsm	武
gs.	共
gsn	計
gs/	残
gak	判
gaj	役
gal	城
gah	院
ga;	他
gai	総
gau	術
gao	支
gay	送
gap	族
ga,	両
gam	乗
ga.	団
gan	松
ga/	映
fdk	応
fdj	済
fdl	線
fdh	買
fd;	設
fdi	右
fdu	供
fdo	格
fdy	病
fdp	打
fd,	視
fdm	早
fd.	勢
fdn	御
fd/	断
fsk	式
fsj	質
fsl	師
fsh	台
fs;	党
fsi	告
fsu	深
fso	存
fsy	争
fsp	室
fs,	覚
fsm	史
fs.	側
fsn	飛
fs/	参
fak	可
faj	態
fal	営
fah	府
fa;	突
fai	巻
fau	容
fao	姿
fay	育
fap	之
fa,	介
fam	建
fa.	南
fan	構
fa/	認
dsk	位
dsj	達
dsl	転
dsh	左
ds;	皇
dsi	宮
dsu	守
dso	満
dsy	消
dsp	任
ds,	医
dsm	蔵
ds.	止
dsn	造
ds/	居
dak	離
daj	根
dal	予
dah	路
da;	字
dai	座
dau	工
dao	寺
day	基
dap	客
da,	急
dam	船
da.	図
dan	追
da/	隊
sak	査
saj	背
sal	観
sah	誰
sa;	黒
sai	素
sau	息
sao	価
say	将
sap	伊
sa,	改
sam	県
sa.	撃
san	失
sa/	泉
qwk	老
qwj	良
qwl	示
qwh	振
qw;	号
qwi	像
qwu	職
qwo	王
qwy	識
qwp	警
qw,	花
qwm	優
qw.	投
qwn	英
qw/	細
qek	局
qej	難
qel	種
qeh	証
qe;	走
qei	念
qeu	寄
qeo	商
qey	青
qep	谷
qe,	害
qem	奥
qe.	派
qen	僕
qe/	佐
qrk	頼
qrj	横
qrl	友
qrh	再
qr;	増
qri	紀
qru	統
qro	答
qry	差
qrp	火
qr,	苦
qrm	器
qr.	収
qrn	段
qr/	異
qtk	血
qtj	護
qtl	紙
qth	俺
qt;	歌
qti	渡
qtu	与
qto	注
qty	条
qtp	演
qt,	算
qtm	赤
qt.	備
qtn	独
qt/	象
wek	清
wej	技
wel	州
weh	申
we;	例
wei	働
weu	景
weo	領
wey	春
wep	抜
we,	遠
wem	橋
we.	源
wen	芸
we/	影
wrk	型
wrj	絶
wrl	館
wrh	眼
wr;	香
wri	負
wru	福
wro	企
wry	旅
wrp	球
wr,	酒
wrm	君
wr.	験
wrn	量
wr/	察
wtk	写
wtj	望
wtl	久
wth	婚
wt;	単
wti	押
wtu	割
wto	限
wty	戻
wtp	科
wt,	求
wtm	津
wt.	案
wtn	談
wt/	降
erk	妻
erj	岡
erl	境
erh	熱
er;	策
eri	浮
eru	階
ero	等
ery	末
erp	宗
er,	区
erm	波
er.	提
ern	去
er/	幸
etk	研
etj	移
etl	域
eth	飲
et;	肉
eti	草
etu	周
eto	昭
ety	越
etp	服
et,	接
etm	鉄
et.	密
etn	司
et/	登
rtk	頃
rtj	銀
rtl	類
rth	検
rt;	未
rti	材
rtu	個
rto	康
rty	沢
rtp	協
rt,	茶
rtm	各
rt.	究
rtn	帯
rt/	規
trk	秀
trj	歴
trl	編
trh	興
tr;	裏
tri	精
tru	洋
tro	率
try	抱
trp	比
tr,	坂
trm	評
tr.	装
trn	監
tr/	崎
tek	省
tej	鮮
tel	税
teh	激
te;	徳
tei	挙
teu	志
teo	労
tey	競
tep	処
te,	退
tem	費
te.	非
ten	囲
te/	喜
twk	辺
twj	敷
twl	系
twh	河
tw;	織
twi	製
twu	娘
two	端
twy	逃
twp	探
tw,	極
twm	遺
tw.	防
twn	低
tw/	犯
tqk	薬
tqj	園
tql	疑
tqh	林
tq;	導
tqi	緒
tqu	静
tqo	具
tqy	席
tqp	房
tq,	速
tqm	街
tq.	舞
tqn	宿
tq/	森
rek	程
rej	丸
rel	胸
reh	陸
re;	倒
rei	寝
reu	宅
reo	兄
rey	療
rep	絵
re,	諸
rem	尾
re.	株
ren	破
re/	秋
rwk	堂
rwj	従
rwl	庭
rwh	管
rw;	婦
rwi	仲
rwu	革
rwo	余
rwy	敵
rwp	展
rw,	訪
rwm	担
rw.	冷
rwn	効
rw/	暮
rqk	腹
rqj	賞
rql	危
rqh	毎
rq;	星
rqi	許
rqu	復
rqo	似
rqy	片
rqp	並
rq,	底
rqm	険
rq.	描
rqn	週
rq/	修
ewk	財
ewj	遊
ewl	温
ewh	軽
ew;	録
ewi	腰
ewu	我
ewo	著
ewy	乱
ewp	章
ew,	雑
ewm	殿
ew.	載
ewn	響
ew/	秘
eqk	布
eqj	恐
eql	攻
eqh	値
eq;	角
eqi	暗
equ	習
eqo	健
eqy	仏
eqp	積
eq,	裁
eqm	試
eq.	夏
eqn	隠
eq/	永
wqk	誌
wqj	夢
wql	環
wqh	援
wq;	故
wqi	幕
wqu	減
wqo	略
wqy	準
wqp	委
wq,	痛
wqm	富
wq.	督
wqn	倉
wq/	弟
zxk	刻
zxj	鳴
zxl	令
zxh	刊
zx;	施
zxi	焼
zxu	欲
zxo	途
zxy	曲
zxp	耳
zx,	完
zxm	里
zx.	願
zxn	罪
zx/	圧
zck	額
zcj	印
zcl	嫌
zch	池
zc;	陽
zci	臣
zcu	庫
zco	継
zcy	亡
zcp	散
zc,	障
zcm	貴
zc.	農
zcn	掛
zc/	板
zvk	昨
zvj	整
zvl	怒
zvh	衆
zv;	恋
zvi	羽
zvu	及
zvo	専
zvy	逆
zvp	腕
zv,	盛
zvm	玄
zv.	留
zvn	礼
zv/	短
zbk	普
zbj	岩
zbl	竹
zbh	児
zb;	毛
zbi	列
zbu	恵
zbo	版
zby	授
zbp	雪
zb,	弾
zbm	宇
zb.	養
zbn	驚
zb/	払
xck	奈
xcj	推
xcl	給
xch	況
xc;	樹
xci	為
xcu	阿
xco	敗
xcy	雄
xcp	捕
xc,	刀
xcm	被
xc.	雨
xcn	岸
xc/	超
xvk	豊
xvj	忘
xvl	含
xvh	弁
xv;	植
xvi	妙
xvu	模
xvo	補
xvy	抗
xvp	級
xv,	休
xvm	暴
xv.	課
xvn	瞬
xv/	称
xbk	跡
xbj	触
xbl	玉
xbh	晴
xb;	華
xbi	因
xbu	震
xbo	折
xby	億
xbp	肩
xb,	劇
xbm	迎
xb.	傷
xbn	悲
xb/	闘
cvk	港
cvj	責
cvl	筋
cvh	訳
cv;	除
cvi	射
cvu	善
cvo	刺
cvy	黙
cvp	柄
cv,	刑
cvm	節
cv.	述
cvn	輪
cv/	困
cbk	脱
cbj	浅
cbl	鳥
cbh	厳
cb;	純
cbi	犬
cbu	博
cbo	陣
cby	薄
cbp	阪
cb,	閉
cbm	吸
cb.	奇
cbn	忠
cb/	韓
vbk	夕
vbj	固
vbl	染
vbh	巨
vb;	講
vbi	微
vbu	髪
vbo	標
vby	束
vbp	縁
vb,	眠
vbm	壁
vb.	午
vbn	般
vb/	湯
bvk	訊
bvj	捨
bvl	駆
bvh	衣
bv;	替
bvi	麻
bvu	甲
bvo	央
bvy	藩
bvp	骨
bv,	彦
bvm	齢
bv.	易
bvn	照
bv/	云
bck	迫
bcj	層
bcl	踏
bch	窓
bc;	弱
bci	討
bcu	聖
bco	典
bcy	剣
bcp	症
bc,	祖
bcm	築
bc.	納
bcn	勤
bc/	昔
bxk	脳
bxj	便
bxl	適
bxh	弥
bx;	融
bxi	航
bxu	快
bxo	浜
bxy	郷
bxp	翌
bx,	旧
bxm	吹
bx.	惑
bxn	柳
bx/	拠
bzk	奉
bzj	筆
bzl	壊
bzh	換
bz;	益
bzi	群
bzu	句
bzo	属
bzy	候
bzp	爆
bz,	功
bzm	捜
bz.	帝
bzn	賀
bz/	魚
vck	堀
vcj	油
vcl	怖
vch	叫
vc;	伸
vci	創
vcu	辞
vco	泣
vcy	憶
vcp	幹
vc,	否
vcm	露
vc.	矢
vcn	承
vc/	雲
vxk	握
vxj	練
vxl	儀
vxh	紹
vx;	聴
vxi	包
vxu	庁
vxo	測
vxy	占
vxp	混
vx,	倍
vxm	乳
vx.	襲
vxn	借
vx/	徴
vzk	荒
vzj	詰
vzl	飯
vzh	栄
vz;	床
vzi	丁
vzu	憲
vzo	則
vzy	禁
vzp	順
vz,	駅
vzm	閣
vz.	昼
vzn	枚
vz/	救
cxk	厚
cxj	皮
cxl	陰
cxh	繰
cx;	那
cxi	冬
cxu	輸
cxo	操
cxy	智
cxp	騒
cx,	己
cxm	濃
cx.	魔
cxn	遅
cx/	簡
czk	撮
czj	携
czl	姉
czh	隣
cz;	孫
czi	丈
czu	煙
czo	黄
czy	曜
czp	宣
cz,	徒
czm	届
cz.	遣
czn	訴
cz/	絡
xzk	茂
xzj	採
xzl	釣
xzh	批
xz;	誘
xzi	核
xzu	哲
xzo	豪
xzy	傾
xzp	締
xz,	欠
xzm	鹿
xz.	就
xzn	迷
xz/	滅
kc	仰
kv	瀬
kx	洗
kb	互
kz	鼻
jc	致
jv	伏
jx	宝
jb	也
jz	杉
lc	患
lv	審
lx	才
lb	延
lz	律
hc	希
hv	避
hx	吾
hb	揺
hz	甘
:c	湾
:v	浦
:x	沈
;b	至
;z	販
ic	裕
iv	更
ix	盟
ib	欧
iz	執
uc	崩
uv	鬼
ux	酸
ub	砂
uz	尊
oc	拡
ov	紅
ox	漢
ob	複
oz	歯
yc	泊
yv	銃
yx	荷
yb	維
yz	盗
pc	枝
pv	縄
px	詩
pb	廃
pz	充
,d	依
,f	鏡
,s	幼
,g	仮
,a	吐
,e	慣
,r	請
,w	晩
,t	眺
,q	沖
,c	斬
,v	躍
,x	威
,b	勇
,z	屈
md	勘
mf	徹
ms	斎
mg	謝
ma	昇
me	艦
mr	寿
mw	催
mt	舎
mq	仁
mc	菜
mv	季
mx	衝
mb	液
mz	箱
.d	到
.f	券
.s	脚
.g	虎
.a	祭
.e	潮
.r	袋
.w	穴
.t	怪
.q	仙
.c	燃
.v	輝
.x	緊
.b	頂
.z	唇
nd	杯
nf	忍
ns	毒
ng	狂
na	札
ne	狙
nr	牛
nw	奪
nt	診
nq	竜
nc	脇
nv	債
nx	鈴
nb	僧
nz	卒
/d	掲
/f	伯
/s	副
/g	皆
/a	敬
/e	熊
/r	針
/w	妹
/t	拝
/q	浴
/c	浪
/v	梅
/x	悩
/b	看
/z	俊
;ld	汚
;lf	摘
;ls	灯
;lg	項
;la	霊
;le	坊
;lr	尻
;lw	垣
;lt	慢
;lq	扱
;lc	渉
;lv	招
;lx	涙
;lb	如
;lz	停
;kd	寒
;kf	叩
;ks	了
;kg	縮
;ka	詳
;ke	旦
;kr	汗
;kw	恥
;kt	慮
;kq	雅
;kc	砲
;kv	謀
;kx	懐
;kb	愚
;kz	郵
;jd	舌
;jf	駄
;js	奴
;jg	幅
;ja	豆
;je	童
;jr	又
;jw	銭
;jt	抑
;jq	侍
;jc	疲
;jv	虫
;jx	宙
;jb	埋
;jz	範
;hd	舟
;hf	闇
;hs	棒
;hg	貨
;ha	龍
;he	肌
;hr	臓
;hw	塩
;ht	籠
;hq	潜
;hc	酔
;hv	呂
;hx	還
;hb	丹
;hz	亜
lkd	亀
lkf	沼
lks	巡
lkg	均
lka	湖
lke	臭
lkr	慶
lkw	距
lkt	釈
lkq	侵
lkc	僚
lkv	貧
lkx	損
lkb	悟
lkz	膝
ljd	猫
ljf	隆
ljs	裂
ljg	尋
lja	貸
lje	旗
ljr	羅
ljw	揮
ljt	辛
ljq	票
ljc	乃
ljv	稲
ljx	胞
ljb	双
ljz	懸
lhd	稿
lhf	塚
lhs	盤
lhg	災
lha	曹
lhe	尽
lhr	嫁
lhw	繁
lht	即
lhq	軒
lhc	績
lhv	帳
lhx	飾
lhb	沿
lhz	獲
kjd	伴
kjf	唐
kjs	狭
kjg	干
kja	添
kje	剤
kjr	姓
kjw	誤
kjt	魅
kjq	契
kjc	掘
kjv	邪
kjx	挑
kjb	免
kjz	爵
khd	択
khf	籍
khs	珍
khg	廊
kha	析
khe	訓
khr	預
khw	輩
kht	敏
khq	署
khc	鶴
khv	虚
khx	努
khb	往
khz	趣
jhd	烈
jhf	索
jhs	匂
jhg	漁
jha	摩
jhe	菊
jhr	緑
jhw	滑
jht	沙
jhq	裸
jhc	孝
jhv	綱
jhx	邸
jhb	弘
jhz	勉
hjd	邦
hjf	揚
hjs	卓
hjg	騎
hja	墓
hje	姫
hjr	畳
hjw	孔
hjt	耐
hjq	須
hjc	臨
hjv	献
hjx	脈
hjb	咲
hjz	貿
hkd	芝
hkf	踊
hks	唱
hkg	封
hka	亭
hke	誕
hkr	貫
hkw	兆
hkt	噂
hkq	偽
hkc	奮
hkv	桜
hkx	熟
hkb	柱
hkz	排
hld	透
hlf	棄
hls	駐
hlg	削
hla	奏
hle	幻
hlr	祝
hlw	麗
hlt	逮
hlq	誠
hlc	炎
hlv	炭
hlx	椅
hlb	寛
hlz	斉
h;d	穂
h;f	柔
h;s	幾
h;g	兼
h;a	飼
h;e	促
h;r	雇
h;w	乾
h;t	尚
h;q	彩
h;c	鋭
h;v	暖
h;x	俗
h;b	較
h;z	傍
jkd	坐
jkf	肝
jks	畑
jkg	濡
jka	笠
jke	峰
jkr	氷
jkw	抵
jkt	恩
jkq	誇
jkc	網
jkv	隅
jkx	渋
jkb	冊
jkz	賛
jld	糸
jlf	魂
jls	牧
jlg	控
jla	澤
jle	紛
jlr	嬉
jlw	廻
jlt	募
jlq	薩
jlc	昌
jlv	戒
jlx	没
jlb	既
jlz	股
j;d	脅
j;f	靖
j;s	征
j;g	覆
j;a	郡
j;e	丘
j;r	佳
j;w	叔
j;t	託
j;q	哀
j;c	肥
j;v	朗
j;x	柴
j;b	慎
j;z	悠
kld	眉
klf	拒
kls	概
klg	顧
kla	硬
kle	腐
klr	塗
klw	挨
klt	孤
klq	拶
klc	憎
klv	却
klx	泥
klb	賊
klz	荘
k;d	宏
k;f	匠
k;s	悔
k;g	朋
k;a	獄
k;e	滞
k;r	脂
k;w	粉
k;t	遇
k;q	淡
k;c	覗
k;v	浩
k;x	購
k;b	併
k;z	崇
l;d	唯
l;f	劉
l;s	垂
l;g	詞
l;a	岐
l;e	俳
l;r	筒
l;w	斜
l;t	嬢
l;q	陥
l;c	掃
l;v	償
l;x	鑑
l;b	勧
l;z	葬
pod	焦
pof	丞
pos	剛
pog	膨
poa	廷
poe	紫
por	銘
pow	鎌
pot	菌
poq	稼
poc	偶
pov	譲
pox	随
pob	猛
poz	李
pid	遂
pif	冒
pis	泰
pig	翼
pia	忙
pie	凄
pir	序
piw	扉
pit	是
piq	寸
pic	賃
piv	偵
pix	澄
pib	殊
piz	緩
pud	頑
puf	杢
pus	塔
pug	賢
pua	拾
pue	紋
pur	撫
puw	麦
put	庄
puq	溜
puc	糖
puv	煮
pux	芳
pub	刷
puz	惨
pyd	歓
pyf	嶋
pys	晋
pyg	虐
pya	喉
pye	旨
pyr	凝
pyw	圏
pyt	卵
pyq	呆
pyc	鷹
pyv	拭
pyx	涯
pyb	貞
pyz	堅
oid	倫
oif	揃
ois	壇
oig	呉
oia	這
oie	械
oir	暇
oiw	皿
oit	頷
oiq	辰
oic	貌
oiv	塞
oix	噴
oib	婆
oiz	岳
oud	祈
ouf	嘉
ous	蹴
oug	鍵
oua	膳
oue	尺
our	桂
ouw	罰
out	漏
ouq	灰
ouc	朱
ouv	召
oux	覧
oub	漂
ouz	汁
oyd	溶
oyf	寂
oys	嘆
oyg	泳
oya	禅
oye	浄
oyr	其
oyw	翔
oyt	酷
oyq	喋
oyc	刃
oyv	漫
oyx	磨
oyb	霧
oyz	暑
iud	粒
iuf	喫
ius	棚
iug	袖
iua	洩
iue	壮
iur	旬
iuw	机
iut	彫
iuq	靴
iuc	庵
iuv	需
iux	偉
iub	鎖
iuz	潰
iyd	貯
iyf	匹
iys	縦
iyg	粧
iya	綿
iye	慌
iyr	穏
iyw	贈
iyt	枠
iyq	謎
iyc	誉
iyv	逸
iyx	駒
iyb	凍
iyz	惜
uyd	措
uyf	瓶
uys	晶
uyg	琴
uya	摂
uye	拍
uyr	稽
uyw	礎
uyt	遭
uyq	帽
uyc	掌
uyv	鍋
uyx	弓
uyb	克
uyz	据
yud	胆
yuf	跳
yus	縛
yug	呟
yua	祐
yue	鎮
yur	雷
yuw	涼
yut	頁
yuq	躰
yuc	恨
yuv	顕
yux	殖
yub	寧
yuz	湧
yid	棋
yif	淳
yis	巧
yig	綾
yia	浸
yie	秒
yir	桃
yiw	隔
yit	班
yiq	甚
yic	妊
yiv	祉
yix	獣
yib	疾
yiz	塾
yod	潟
yof	湿
yos	幡
yog	撲
yoa	塊
yoe	槍
yor	絞
yow	履
yot	苗
yoq	芋
yoc	冗
yov	陶
yox	励
yob	陳
yoz	篠
ypd	藝
ypf	陀
yps	喧
ypg	猿
ypa	於
ype	葛
ypr	傘
ypw	蒸
ypt	禄
ypq	啓
ypc	劣
ypv	撤
ypx	殴
ypb	盾
ypz	貰
uid	衰
uif	栗
uis	滝
uig	慰
uia	馴
uie	蛇
uir	梨
uiw	癖
uit	潤
uiq	菓
uic	鉢
uiv	洲
uix	戯
uib	腸
uiz	偏
uod	駕
uof	巣
uos	宴
uog	耕
uoa	炉
uoe	棟
uor	洞
uow	睨
uot	狩
uoq	陛
uoc	鴨
uov	磁
uox	潔
uob	膜
uoz	乏
upd	祥
upf	曾
ups	淵
upg	舗
upa	抽
upe	桐
upr	駿
upw	睡
upt	賭
upq	括
upc	貢
upv	犠
upx	粗
upb	卑
upz	貼
iod	拉
iof	蘭
ios	牲
iog	帆
ioa	挿
ioe	翻
ior	胡
iow	羊
iot	枕
ioq	錯
ioc	謙
iov	鉱
iox	珠
iob	蓄
ioz	儲
ipd	伍
ipf	拓
ips	鼓
ipg	膚
ipa	粋
ipe	尉
ipr	胃
ipw	后
ipt	粘
ipq	披
ipc	徐
ipv	悦
ipx	堪
ipb	挟
ipz	冠
opd	郊
opf	愉
ops	蘇
opg	此
opa	狼
ope	尿
opr	顎
opw	蝶
opt	魏
opq	誓
opc	憂
opv	舐
opx	蔦
opb	簿
opz	糧
/.d	架
/.f	筈
/.s	芽
/.g	軸
/.a	輔
/.e	苛
/.r	蓋
/.w	爺
/.t	銅
/.q	圭
/.c	盆
/.v	紗
/.x	凶
/.b	妃
/.z	哉
/,d	庶
/,f	秩
/,s	裾
/,g	幽
/,a	凡
/,e	猪
/,r	惚
/,w	漠
/,t	拙
/,q	郁
/,c	嘩
/,v	恒
/,x	暦
/,b	腫
/,z	峠
/md	篇
/mf	宰
/ms	蒼
/mg	蛮
/ma	窮
/me	擦
/mr	爪
/mw	稚
/mt	夷
/mq	辱
/mc	嵐
/mv	憤
/mx	癒
/mb	鬱
/mz	疎
/nd	雰
/nf	溢
/ns	彰
/ng	蓮
/na	肺
/ne	傑
/nr	拘
/nw	頻
/nt	緯
/nq	妖
/nc	豚
/nv	或
/nx	藍
/nb	矛
/nz	鍛
.,d	繊
.,f	縫
.,s	把
.,g	楼
.,a	捉
.,e	牢
.,r	漬
.,w	腿
.,t	紳
.,q	飽
.,c	宛
.,v	閥
.,x	旋
.,b	坪
.,z	菩
.md	崖
.mf	幌
.ms	叱
.mg	鶏
.ma	鈍
.me	峡
.mr	吊
.mw	溝
.mt	逢
.mq	朴
.mc	軌
.mv	瓦
.mx	喪
.mb	墨
.mz	疫
.nd	貝
.nf	鮎
.ns	遍
.ng	梁
.na	堺
.ne	濁
.nr	缶
.nw	扇
.nt	枯
.nq	拳
.nc	揉
.nv	乙
.nx	酵
.nb	辻
.nz	馳
,md	堤
,mf	宋
,ms	阻
,mg	桑
,ma	雀
,me	虜
,mr	綺
,mw	牡
,mt	樽
,mq	怯
,mc	乞
,mv	恭
,mx	鐘
,mb	喰
,mz	剰
,nd	慈
,nf	径
,ns	培
,ng	擁
,na	郭
,ne	呪
,nr	尖
,nw	砕
,nt	趙
,nq	汰
,nc	勃
,nv	翁
,nx	絹
,nb	壺
,nz	譜
mnd	陵
mnf	痴
mns	笛
mng	昧
mna	訟
mne	駈
mnr	唾
mnw	漱
mnt	肪
mnq	塀
mnc	髙
mnv	蒲
mnx	碁
mnb	惣
mnz	敢
nmd	祀
nmf	塁
nms	洛
nmg	滴
nma	囁
nme	暁
nmr	胴
nmw	菱
nmt	謡
nmq	秦
nmc	紐
nmv	卿
nmx	飢
nmb	麿
nmz	欄
n,d	艶
n,f	菅
n,s	痕
n,g	怠
n,a	恰
n,e	欺
n,r	弦
n,w	泡
n,t	晃
n,q	諦
n,c	敦
n,v	伐
n,x	餅
n,b	歪
n,z	寮
n.d	昂
n.f	符
n.s	厄
n.g	奔
n.a	瞳
n.e	昆
n.r	亮
n.w	噌
n.t	椎
n.q	懇
n.c	唄
n.v	渦
n.x	襟
n.b	吟
n.z	蜀
n/d	覇
n/f	衡
n/s	畜
n/g	呈
n/a	隙
n/e	淫
n/r	娠
n/w	循
n/t	矩
n/q	懲
n/c	錦
n/v	棲
n/x	叡
n/b	猟
n/z	袁
m,d	幣
m,f	附
m,s	箇
m,g	梶
m,a	醜
m,e	軟
m,r	箸
m,w	濯
m,t	戚
m,q	喚
m,c	窺
m,v	紺
m,x	某
m,b	鋼
m,z	褒
m.d	魯
m.f	蒙
m.s	惹
m.g	赴
m.a	媒
m.e	隈
m.r	妬
m.w	遮
m.t	窯
m.q	侯
m.c	隻
m.v	釜
m.x	茎
m.b	蔑
m.z	狐
m/d	嗅
m/f	杖
m/s	壌
m/g	蜜
m/a	尼
m/e	肢
m/r	赦
m/w	酬
m/t	戴
m/q	詠
m/c	斗
m/v	鄭
m/x	宜
m/b	殻
m/z	墳
,.d	炊
,.f	碑
,.s	柏
,.g	伺
,.a	但
,.e	奨
,.r	践
,.w	滋
,.t	毅
,.q	儒
,.c	沸
,.v	皺
,.x	薦
,.b	蓮
,.z	騙
,/d	禿
,/f	磯
,/s	怨
,/g	姜
,/a	曇
,/e	栽
,/r	刈
,/w	閑
,/t	錠
,/q	扶
,/c	斐
,/v	妥
,/x	仇
,/b	妨
,/z	苑
./d	萩
./f	醒
./s	詣
./g	胎
./a	窟
./e	巾
./r	蜂
./w	忌
./t	唸
./q	賑
./c	骸
./v	弄
./x	嫉
./b	漕
./z	烏
awk	粛
awj	罵
awl	囚
awh	諏
aw;	呻
awi	鉛
awu	肯
awo	桶
awy	燥
awp	搭
aw,	諭
awm	愕
aw.	璧
awn	辿
aw/	阜
aek	喝
aej	贅
ael	享
aeh	靴
ae;	騰
aei	嗣
aeu	鵜
aeo	巳
aey	勅
aep	襖
ae,	篤
aem	孟
ae.	筑
aen	勲
ae/	埼
ark	伎
arj	咳
arl	堵
arh	曖
ar;	只
ari	燈
aru	詐
aro	國
ary	笹
arp	綴
ar,	餌
arm	稀
ar.	焚
arn	岬
ar/	曽
atk	條
atj	霞
atl	暫
ath	播
at;	讃
ati	雰
atu	爽
ato	盃
aty	燭
atp	肖
at,	瞳
atm	滲
at.	詮
atn	倭
at/	諾
sek	零
sej	柿
sel	芯
seh	喘
se;	淀
sei	莫
seu	讐
seo	綻
sey	詫
sep	董
se,	訂
sem	龍
se.	蔭
sen	捧
se/	楚
srk	汲
srj	蕎
srl	汽
srh	薫
sr;	竿
sri	隷
sru	碗
sro	鳩
sry	俵
srp	傳
sr,	窪
srm	妾
sr.	姑
srn	遷
sr/	髭
stk	枢
stj	肘
stl	麓
sth	痺
st;	憧
sti	兎
stu	帥
sto	漆
sty	酌
stp	庇
st,	頓
stm	賠
st.	渇
stn	慕
st/	塵
drk	叶
drj	裡
drl	拗
drh	婿
dr;	妄
dri	藪
dru	慨
dro	匿
dry	寅
drp	渓
dr,	眸
drm	穿
dr.	眞
drn	聡
dr/	遥
dtk	侮
dtj	髄
dtl	悶
dth	穀
dt;	勿
dti	瑞
dtu	蟹
dto	鳳
dty	厭
dtp	薪
dt,	轄
dtm	臥
dt.	憑
dtn	洪
dt/	拳
ftk	牙
ftj	咽
ftl	迅
fth	該
ft;	逐
fti	杏
ftu	嘲
fto	釘
fty	楠
ftp	廣
ft,	墜
ftm	臆
ft.	餓
ftn	挫
ft/	淋
axk	訝
axj	楊
axl	芥
axh	錬
ax;	桟
axi	琉
axu	樺
axo	溺
axy	賄
axp	盲
ax,	鯨
axm	佑
ax.	侶
axn	剃
ax/	荻
ack	娼
acj	迦
acl	袴
ach	艇
ac;	杜
aci	丼
acu	洒
aco	俣
acy	眩
acp	堕
ac,	忽
acm	揆
ac.	瞼
acn	旭
ac/	瘍
avk	槽
avj	憩
avl	僅
avh	諜
av;	閲
avi	獅
avu	渕
avo	糞
avy	鞘
avp	咎
av,	柵
avm	鞭
av.	禰
avn	畔
av/	躇
abk	睦
abj	蝦
abl	唆
abh	躊
ab;	悼
abi	茜
abu	垢
abo	吏
aby	穫
abp	酢
ab,	姐
abm	玲
ab.	砦
abn	函
ab/	苔
sck	賜
scj	腎
scl	叛
sch	鼠
sc;	梗
sci	牌
scu	瑠
sco	儂
scy	琶
scp	伽
sc,	帖
scm	瓜
sc.	煽
scn	簾
sc/	嶺
svk	羨
svj	搬
svl	琵
svh	剖
sv;	酎
svi	畿
svu	宵
svo	拐
svy	峯
svp	醸
sv,	茫
svm	闇
sv.	猶
svn	鷲
sv/	絆
sbk	諮
sbj	畏
sbl	吠
sbh	泌
sb;	槌
sbi	轟
sbu	隙
sbo	愁
sby	橘
sbp	埃
sb,	冴
sbm	薙
sb.	逝
sbn	稔
sb/	頸
dvk	朽
dvj	硫
dvl	厨
dvh	瞭
dv;	殆
dvi	甥
dvu	癌
dvo	擬
dvy	憐
dvp	仔
dv,	叙
dvm	辻
dv.	弊
dvn	累
dv/	妓
dbk	煩
dbj	踪
dbl	裳
dbh	輿
db;	梯
dbi	藻
dbu	荼
dbo	諫
dby	膣
dbp	蚊
db,	牽
dbm	薇
db.	栃
dbn	且
db/	笥
fbk	罠
fbj	蹟
fbl	鋳
fbh	蔽
fb;	薔
fbi	珊
fbu	茨
fbo	雛
fby	狽
fbp	汝
fb,	棺
fbm	註
fb.	舵
fbn	慄
fb/	瀧
qsk	傲
qsj	裟
qsl	吻
qsh	曳
qs;	隼
qsi	萌
qsu	斐
qso	芭
qsy	藁
qsp	硝
qs,	晒
qsm	舶
qs.	臀
qsn	盧
qs/	韋
qdk	租
qdj	狸
qdl	摺
qdh	倣
qd;	謹
qdi	抹
qdu	曼
qdo	虹
qdy	捻
qdp	娯
qd,	箕
qdm	臼
qd.	濤
qdn	喩
qd/	襞
qfk	鞄
qfj	萎
qfl	攣
qfh	撒
qf;	濠
qfi	槻
qfu	鋒
qfo	凌
qfy	俯
qfp	稽
qf,	緋
qfm	蛍
qf.	蕉
qfn	芦
qf/	姦
qgk	窒
qgj	噺
qgl	湊
qgh	韓
qg;	腺
qgi	桁
qgu	玩
qgo	冶
qgy	羞
qgp	袈
qg,	奢
qgm	娥
qg.	佇
qgn	媚
qg/	栓
wdk	叉
wdj	鯉
wdl	惧
wdh	寵
wd;	閃
wdi	掠
wdu	錏
wdo	寡
wdy	櫓
wdp	哢
wd,	攘
wdm	鞍
wd.	砥
wdn	畝
wd/	淑
wfk	嫡
wfj	迂
wfl	腔
wfh	屯
wf;	糾
wfi	凰
wfu	艘
wfo	纏
wfy	櫻
wfp	翠
wf,	而
wfm	檜
wf.	猥
wfn	炒
wf/	鎧
wgk	屍
wgj	秤
wgl	撥
wgh	莉
wg;	遡
wgi	肴
wgu	衿
wgo	狗
wgy	陪
wgp	謳
wg,	翳
wgm	雌
wg.	峨
wgn	瑜
wg/	八
efk	舷
efj	昏
efl	葵
efh	舘
ef;	挺
efi	葡
efu	踵
efo	允
efy	筑
efp	霜
ef,	殉
efm	覇
ef.	紡
efn	榊
ef/	貪
egk	甦
egj	梓
egl	餉
egh	庸
eg;	套
egi	逞
egu	些
ego	韻
egy	灌
egp	繕
eg,	搾
egm	椿
eg.	軋
egn	燕
eg/	樋
rgk	刹
rgj	采
rgl	岸
rgh	嵯
rg;	堆
rgi	禍
rgu	磐
rgo	祇
rgy	醍
rgp	檀
rg,	茅
rgm	雁
rg.	咄
rgn	煎
rg/	姻
zsk	醐
zsj	杭
zsl	閤
zsh	瞑
zs;	斑
zsi	冥
zsu	峙
zso	遙
zsy	粥
zsp	抄
zs,	痙
zsm	遁
zs.	肚
zsn	拷
zs/	遜
zdk	饅
zdj	旺
zdl	蔓
zdh	曰
zd;	壕
zdi	准
zdu	耶
zdo	勾
zdy	廉
zdp	儘
zd,	亨
zdm	捲
zd.	爾
zdn	屑
zd/	榎
zfk	螺
zfj	蛙
zfl	餐
zfh	礁
zf;	腑
zfi	蕩
zfu	萬
zfo	縞
zfy	鏑
zfp	壱
zf,	鴻
zfm	嵌
zf.	畠
zfn	樫
zf/	升
zgk	挽
zgj	芙
zgl	灘
zgh	廓
zg;	鉤
zgi	卸
zgu	蟻
zgo	嗟
zgy	﨑
zgp	耗
zg,	倖
zgm	兜
zg.	蜘
zgn	謁
zg/	璃
xdk	坑
xdj	擢
xdl	蛛
xdh	串
xd;	鳶
xdi	渾
xdu	絨
xdo	倶
xdy	黎
xdp	焉
xd,	稜
xdm	弔
xd.	寇
xdn	惟
xd/	賓
xfk	粕
xfj	卯
xfl	袂
xfh	叢
xf;	廟
xfi	巌
xfu	丑
xfo	耽
xfy	疼
xfp	轢
xf,	几
xfm	俄
xf.	痢
xfn	煌
xf/	鴉
xgk	乍
xgj	嚇
xgl	濫
xgh	萄
xg;	謎
xgi	俸
xgu	訛
xgo	嗚
xgy	闊
xgp	鸞
xg,	伎
xgm	湛
xg.	嗜
xgn	妄
xg/	梢
cfk	箋
cfj	聚
cfl	灼
cfh	茸
cf;	蒔
cfi	椀
cfu	柑
cfo	慧
cfy	巴
cfp	賤
cf,	按
cfm	暢
cf.	髷
cfn	甫
cf/	粟
cgk	邑
cgj	檻
cgl	凸
cgh	倅
cg;	輛
cgi	鯛
cgu	瞠
cgo	瞥
cgy	墟
cgp	坦
cg,	脊
cgm	鰻
cg.	詔
cgn	遼
cg/	緻
vgk	牝
vgj	凜
vgl	晦
vgh	嬌
vg;	圃
vgi	咥
vgu	凹
vgo	楯
vgy	鄧
vgp	錆
vg,	罹
vgm	彷
vg.	凱
vgn	櫛
vg/	跨
;od	嶽
;of	鍬
;os	諒
;og	巫
;oa	煉
;oe	籠
;or	譚
;ow	祠
;ot	脆
;oq	胤
;oc	罷
;ov	曝
;ox	啜
;ob	棹
;oz	巷
;id	幀
;if	戮
;is	漸
;ig	贋
;ia	汐
;ie	栖
;ir	掬
;iw	訣
;it	牟
;iq	襄
;ic	爛
;iv	捏
;ix	荊
;ib	峻
;iz	纂
;ud	撰
;uf	冨
;us	賦
;ug	杵
;ua	弧
;ue	歎
;ur	饒
;uw	糊
;ut	佛
;uq	褐
;uc	鮭
;uv	鱗
;ux	嗤
;ub	弛
;uz	掟
;yd	綸
;yf	僻
;ys	欽
;yg	礫
;ya	辣
;ye	摯
;yr	刎
;yw	揶
;yt	來
;yq	揄
;yc	堰
;yv	飴
;yx	碧
;yb	鰹
;yz	蹄
lid	憧
lif	魁
lis	匕
lig	濱
lia	瑛
lie	汎
lir	葺
liw	誅
lit	劫
liq	憚
lic	斯
liv	遽
lix	靄
lib	謂
liz	埒
lud	欣
luf	毯
lus	玖
lug	鞋
lua	沫
lue	胚
lur	捷
luw	癪
lut	姪
luq	啼
luc	荀
luv	斥
lux	梵
lub	饉
luz	彬
lyd	瀕
lyf	傭
lys	楓
lyg	郤
lya	亦
lye	厘
lyr	迄
lyw	獏
lyt	倦
lyq	紘
lyc	抉
lyv	矯
lyx	犀
lyb	蛭
lyz	鉉
kud	狡
kuf	萌
kus	毘
kug	毀
kua	奸
kue	淹
kur	耆
kuw	艸
kut	崔
kuq	舅
kuc	窃
kuv	顰
kux	遼
kub	颯
kuz	戟
kyd	嵩
kyf	蓬
kys	疹
kyg	扮
kya	逍
kye	仄
kyr	舜
kyw	瑚
kyt	疵
kyq	鮨
kyc	斧
kyv	焔
kyx	厩
kyb	喬
kyz	臍
jyd	靡
jyf	卜
jys	屹
jyg	奕
jya	麟
jye	恍
jyr	采
jyw	哨
jyt	歿
jyq	茉
jyc	遵
jyv	熾
jyx	蔡
jyb	頑
jyz	萱
;.d	懿
;.f	竦
;.s	蠣
;.g	賂
;.a	學
;.e	逗
;.r	惰
;.w	禎
;.t	腋
;.q	裔
;.c	蕃
;.v	瀾
;.x	桓
;.b	蚕
;.z	脛
;,d	冑
;,f	葱
;,s	咤
;,g	悸
;,a	膏
;,e	泄
;,r	憫
;,w	寓
;,t	鵬
;,q	于
;,c	齋
;,v	彅
;,x	沁
;,b	捌
;,z	氾
;md	做
;mf	勒
;ms	蠅
;mg	乎
;ma	舳
;me	聯
;mr	贔
;mw	屁
;mt	肛
;mq	隙
;mc	朧
;mv	趨
;mx	諧
;mb	錫
;mz	屓
;nd	僑
;nf	痒
;ns	泪
;ng	倹
;na	躾
;ne	宥
;nr	款
;nw	狄
;nt	嘗
;nq	鮫
;nc	橇
;nv	鑿
;nx	哭
;nb	斡
;nz	亘
l,d	憮
l,f	蘆
l,s	沌
l,g	媛
l,a	襲
l,e	粂
l,r	竪
l,w	讀
l,t	孕
l,q	篝
l,c	跪
l,v	磚
l,x	肱
l,b	笙
l,z	悉
lmd	槙
lmf	扁
lms	榴
lmg	痩
lma	肋
lme	穢
lmr	那
lmw	沓
lmt	椒
lmq	縋
lmc	拐
lmv	渚
lmx	尤
lmb	檎
lmz	茹
lnd	絢
lnf	悴
lns	瞞
lng	躱
lna	憾
lne	呵
lnr	殷
lnw	堡
lnt	虔
lnq	怜
lnc	茄
lnv	戊
lnx	咬
lnb	筵
lnz	隋
kmd	佃
kmf	瘤
kms	嘔
kmg	聳
kma	誦
kme	趾
kmr	糠
kmw	哺
kmt	恫
kmq	聟
kmc	蕾
kmv	雍
kmx	馨
kmb	絃
kmz	肇
knd	蒐
knf	銚
kns	凛
kng	蛆
kna	蠢
kne	偲
knr	楕
knw	悍
knt	斃
knq	賽
knc	軫
knv	豹
knx	蝕
knb	袢
knz	湘
jnd	媛
jnf	辟
jns	凪
jng	勁
jna	托
jne	炸
jnr	奄
jnw	宕
jnt	褪
jnq	癇
jnc	蕪
jnv	攫
jnx	錨
jnb	錐
jnz	綜
pld	襦
plf	攪
pls	燻
plg	燦
pla	藉
ple	銜
plr	珂
plw	矧
plt	囃
plq	缺
plc	拵
plv	晰
plx	淮
plb	蛋
plz	蓑
pkd	膵
pkf	捺
pks	麾
pkg	炬
pka	已
pke	捩
pkr	鄙
pkw	印
pkt	衷
pkq	苫
pkc	圓
pkv	徨
pkx	暈
pkb	絲
pkz	螢
pjd	袱
pjf	彙
pjs	膠
pjg	蠍
pja	吃
pje	弼
pjr	亥
pjw	厠
pjt	窩
pjq	桔
pjc	屠
pjv	框
pjx	聰
pjb	迭
pjz	邁
phd	渥
phf	蕗
phs	婢
phg	簀
pha	髯
phe	埠
phr	彗
phw	澱
pht	臺
phq	柚
phc	窄
phv	箔
phx	祟
phb	熙
phz	轍
okd	嘱
okf	應
oks	驕
okg	壬
oka	脹
oke	煤
okr	恣
okw	鼎
okt	嘴
okq	膿
okc	鋸
okv	墾
okx	瓢
okb	蓉
okz	堯
ojd	耀
ojf	誼
ojs	簪
ojg	聘
oja	舘
oje	輯
ojr	貶
ojw	﨟
ojt	柩
ojq	霖
ojc	鮒
ojv	彌
ojx	棘
ojb	逡
ojz	鬢
ohd	璃
ohf	褌
ohs	燿
ohg	與
oha	團
ohe	鰊
ohr	澪
ohw	猾
oht	嗄
ohq	饗
ohc	杓
ohv	逼
ohx	埴
ohb	燐
ohz	呷
ijd	掏
ijf	痣
ijs	顫
ijg	脩
ija	惠
ije	涎
ijr	疇
ijw	竈
ijt	躙
ijq	渠
ijc	侘
ijv	擲
ijx	滸
ijb	硯
ijz	筧
ihd	賈
ihf	櫃
ihs	謗
ihg	邇
iha	岱
ihe	涸
ihr	糺
ihw	朔
iht	廿
ihq	冀
ihc	咸
ihv	赳
ihx	靭
ihb	椋
ihz	痰
uhd	閻
uhf	汀
uhs	疋
uhg	棍
uha	睫
uhe	芒
uhr	鋏
uhw	惇
uht	剌
uhq	帷
uhc	謐
uhv	睾
uhx	碩
uhb	朶
uhz	蹲
/ld	琳
/lf	槇
/ls	笈
/lg	緬
/la	弗
/le	會
/lr	鬨
/lw	燗
/lt	釧
/lq	駁
/lc	襷
/lv	碇
/lx	榜
/lb	漿
/lz	炙
/kd	翰
/kf	匡
/ks	兇
/kg	壜
/ka	舛
/ke	幟
/kr	搦
/kw	朦
/kt	鍔
/kq	鰯
/kc	乖
/kv	站
/kx	魄
/kb	鶯
/kz	撥
/jd	摸
/jf	邊
/js	譚
/jg	廠
/ja	匪
/je	瞰
/jr	祓
/jw	姥
/jt	榛
/jq	凋
/jc	庖
/jv	璋
/jx	飄
/jb	徊
/jz	蟠
/hd	鬚
/hf	龕
/hs	逓
/hg	筏
/ha	彿
/he	燵
/hr	甕
/hw	褄
/ht	傅
/hq	儡
/hc	釉
/hv	剋
/hx	截
/hb	經
/hz	傀
.kd	皓
.kf	邉
.ks	耀
.kg	壽
.ka	夥
.ke	疆
.kr	劾
.kw	鍾
.kt	噤
.kq	戍
.kc	梟
.kv	檮
.kx	洟
.kb	熄
.kz	鞠
.jd	凧
.jf	恢
.js	雫
.jg	誹
.ja	伜
.je	瀟
.jr	艾
.jw	掩
.jt	匙
.jq	殲
.jc	漲
.jv	躁
.jx	吼
.jb	麺
.jz	毬
.hd	矜
.hf	莞
.hs	菖
.hg	酪
.ha	尹
.he	汪
.hr	芻
.hw	醤
.ht	慇
.hq	鯖
.hc	蛤
.hv	匁
.hx	浙
.hb	瑕
.hz	艫
,jd	咀
,jf	啖
,js	懣
,jg	檄
,ja	禮
,je	鱒
,jr	懃
,jw	鉾
,jt	徘
,jq	戎
,jc	鉦
,jv	滔
,jx	灸
,jb	穆
,jz	奎
,hd	幇
,hf	骸
,hs	滾
,hg	鱈
,ha	淘
,he	德
,hr	椰
,hw	毫
,ht	躅
,hq	宍
,hc	沃
,hv	娶
,hx	嶌
,hb	躑
,hz	鼾
mhd	禽
mhf	塑
mhs	痘
mhg	憬
mha	實
mhe	烙
mhr	籐
mhw	粮
mht	贖
mhq	吉
mhc	漉
mhv	朕
mhx	娩
mhb	悧
mhz	箒
grk	蜻
grj	贄
grl	麒
grh	珈
gr;	當
gri	蛉
gru	禦
gro	諺
gry	稟
grp	蹂
gr,	竺
grm	牒
gr.	烹
grn	丕
gr/	欒
gek	嬲
gej	萬
gel	紬
geh	緋
ge;	梃
gei	樅
geu	盥
geo	磔
gey	縣
gep	膀
ge,	虞
gem	凭
ge.	抒
gen	拮
ge/	齧
gwk	諦
gwj	嬰
gwl	徽
gwh	苧
gw;	塹
gwi	閨
gwu	鷺
gwo	懺
gwy	枡
gwp	竄
gw,	丙
gwm	胱
gw.	閏
gwn	咆
gw/	屏
gqk	戌
gqj	榮
gql	羌
gqh	舁
gq;	韮
gqi	崗
gqu	猜
gqo	噛
gqy	嚥
gqp	游
gq,	琥
gqm	矮
gq.	腱
gqn	鰓
gq/	華
fek	教
fej	匈
fel	爲
feh	憔
fe;	櫂
fei	縊
feu	諍
feo	斤
fey	杷
fep	焙
fe,	絣
fem	祁
fe.	冤
fen	圀
fe/	拿
fwk	澹
fwj	躓
fwl	餃
fwh	穣
fw;	佩
fwi	恁
fwu	槿
fwo	馘
fwy	芹
fwp	譬
fw,	跋
fwm	頽
fw.	駝
fwn	綽
fw/	馮
fqk	鋤
fqj	獰
fql	箭
fqh	囮
fq;	斂
fqi	泛
fqu	秣
fqo	鉈
fqy	懼
fqp	梳
fq,	疱
fqm	迸
fq.	寬
fqn	琢
fq/	褐
dwk	嚼
dwj	戈
dwl	瘡
dwh	臂
dw;	帛
dwi	橙
dwu	煕
dwo	庚
dwy	柾
dwp	濾
dw,	衒
dwm	謖
dw.	叟
dwn	怕
dw/	漑
dqk	珀
dqj	禹
dql	緞
dqh	裃
dq;	縷
dqi	諷
dqu	轡
dqo	掻
dqy	捗
dqp	俘
dq,	崋
dqm	撼
dq.	銛
dqn	鐵
dq/	撞
sqk	俟
sqj	剽
sql	駱
sqh	梱
sq;	恪
sqi	昵
squ	莢
sqo	鍼
sqy	楢
sqp	擡
sq,	葭
sqm	麩
sq.	偃
sqn	曼
sq/	梧
sqk	嶮
gvj	悄
gvl	仆
gvh	嘯
gv;	朔
gvi	弐
gvu	敲
gvo	頤
gvy	馭
gvp	廬
gv,	茨
gvm	蛾
gv.	琢
gvn	牀
gv/	琲
gck	奘
gcj	竟
gcl	黴
gch	豹
gc;	碍
gci	俎
gcu	寨
gco	筍
gcy	鑽
gcp	皐
gc,	酋
gcm	什
gc.	喊
gcn	徠
gc/	槃
gxk	翅
gxj	曙
gxl	舩
gxh	竣
gx;	枇
gxi	籾
gxu	訥
gxo	鰺
gxy	哮
gxp	涅
gx,	舫
gxm	苺
gx.	兌
gxn	處
gx/	恃
gzk	枷
gzj	餞
gzl	赫
gzh	蛸
gz;	桧
gzi	爬
gzu	彪
gzo	抛
gzy	杞
gzp	蟇
gz,	訃
gzm	扈
gz.	術
gzn	謄
gz/	繭
fck	璽
fcj	勺
fcl	錘
fch	銑
fc;	頒
